10111
10001
11101
10001
10111
10000
11101