0011011111
0010011110
0010100010
1110001000
1100001001
1100110001
1011000010
0111110000
011100001100
1010011000