111111
000001
100001
100001
100001
111101