101111111111
100000000011
101111111111
101111111111
100011111111
111011111111
111000011111
111111000011
111111111000