11111111111111111111111
10001000000111111111111
10101011110111100000000
10101011110111101111111
10101011110100001111111
00100011110001111111111
11111111111111111111111